############################
#..........N...............#
#..........................#
#......D...................#
#..........................#
#..........P...............#
#..........................#
############################